11111111
11C00001
1E0PE0C1
10100C01
11111111
