111111111111111
1P0C000000C0001
10C000011111111
10C110C000000E1
111111111111111