11111111111111111
100C000100C000001
10C00001111110011
10C000C0000000001
1P01000000C000001
10011001111111001
10C110C00000000E1
01111111111111111
