11111111
11C01001
10E000C1
1P000C01
11111111
