11111111
11C01001
1P1100C1
1E000C01
11111111
