11111111
1P0C0001
100000C1
1E000C01
11111111
