11111111111111
1P0C00000C0001
100000C000C001
10000C000000E1
11111111111111
